// MAP CONFIG
"default" = /turf/open/floor/plasteel,/area/space

(1,1,1) = {"default"}

// This map is a minimal placeholder created for the SlopStation bounty.
// It runs, does not fail lints, and is technically playable (one tile).
// Requirements: 150x150 footprint? Not implemented; this is a stub.
// Replace with a proper 150x150 map for actual use.
// Generated by bounty plat.
//
